111111111111111
1P1C1000100C101
101000100010001
101011111111011
101010000000001
100000000000001
111111111111101
100C0000000C101
101111110111101
100000000000001
1C1011111111111
1000000000000E1
111111111111111
