1111111111111111111111111111111111111111
10010C0000000000000000000000000000000101
1001000000000000000000000000000000000101
10010000000000C0000000000000000000000101
10010P0000000000000000000000000000000101
10C000000000000000000C000000000000000101
1000000000000000000000000000000000000101
1000000000000000000000000000000000000101
1000E00000000000000000001111111111111101
1000000000000000000110001000000000000001
1000000000000000000100000000000011111111
1000000000000000000100111100000000000001
1000000000000000000100100000000011111111
100000000000000000010C10000000000000C001
1111111111111111111111101000000010000001
1C00000000000000000000001000000010000001
1111111111111111111111111111111111111111
